8.ox
.....ooo
.....ooo
..o.o..o
..o.....
..oo...o
...o...o
.o...o..
........
